POSTING DATE,TRANSACTION DATE,TAG/PLATE NUMBER,AGENCY,DESCRIPTION,ENTRY TIME,ENTRY PLAZA,ENTRY LANE,EXIT TIME,EXIT PLAZA,EXIT LANE,VEHICLE TYPE CODE,AMOUNT,PREPAID,PLAN/RATE,FARE TYPE,BALANCE
09/06/2023,09/03/2023,02214781099,NYSTA,TOLL,18:04:48,44 ,11E,18:22:05,41 ,03X,2L,($1.37),Y,BUSINESS,N,$1171.88
09/06/2023,09/03/2023,02214781099,NYSTA,TOLL,17:00:32,50 ,02E,17:32:58,47 ,11E,2L,($2.15),Y,BUSINESS,N,$1173.25
09/06/2023,09/06/2023,02214781096,NJTP,TOLL,08:15:16,10 ,13E,08:18:26,11 ,20X,1,($1.28),Y,BUSINESS,N,$1175.40
09/06/2023,09/05/2023,02214781098,MTAB&T,TOLL,,-,-,21:41:56,TNB,005,-,($11.19),Y,BUSINESS,N,$1176.68
09/06/2023,09/05/2023,02214781098,MTAB&T,TOLL,,-,-,21:15:12,TNB,003,-,($11.19),Y,BUSINESS,N,$1187.87
09/06/2023,09/06/2023,02212261422,GSP,TOLL,,-,-,07:44:51,BRS,01S,1,($0.70),Y,BUSINESS,N,$1199.06
09/06/2023,08/09/2023,Z353579-NJ,GSP,TOLL,,-,-,17:21:37,BAR,05s,1,($2.02),Y,BUSINESS,N,$1199.76
09/06/2023,08/11/2023,G53RRF-NJ,GSP,TOLL,,-,-,00:47:33,RAS,13s,1,($2.02),Y,BUSINESS,N,$1201.78
09/06/2023,09/05/2023,02214781087,GSP,TOLL,,-,-,22:31:07,LWS,01S,1,($0.70),Y,BUSINESS,N,$1203.80
09/05/2023,09/05/2023,02214781092,GSP,TOLL,,-,-,21:07:35,NGR,06N,1,($2.02),Y,BUSINESS,N,$1204.50
09/05/2023,09/05/2023,02214781092,GSP,TOLL,,-,-,20:28:10,CMY,07N,1,($2.02),Y,BUSINESS,N,$1206.52
09/05/2023,09/05/2023,02214781092,GSP,TOLL,,-,-,18:36:17,GEG,04S,1,($2.02),Y,BUSINESS,N,$1208.54
09/05/2023,09/05/2023,02212261422,GSP,TOLL,,-,-,20:02:18,LWN,01N,1,($0.70),Y,BUSINESS,N,$1210.56
09/05/2023,09/05/2023,02214781092,GSP,TOLL,,-,-,17:53:40,BAR,08S,1,($2.02),Y,BUSINESS,N,$1211.26
09/05/2023,09/05/2023,02214781092,GSP,TOLL,,-,-,14:24:31,TRV,06N,1,($1.01),Y,BUSINESS,N,$1213.28
09/05/2023,09/04/2023,P46SKT-NJ,PANYNJ,TOLL,,-,-,19:52:15,OBX,08,-,($14.75),Y,BUSINESS,N,$1214.29
09/05/2023,09/04/2023,02212261422,PANYNJ,TOLL,,-,-,19:30:54,OBX,04,-,($14.75),Y,BUSINESS,N,$1229.04
09/05/2023,09/04/2023,P46SKT-NJ,MTAB&T,TOLL,,-,-,23:01:58,VNB,007,-,($11.19),Y,BUSINESS,N,$1243.79
09/05/2023,09/05/2023,02214781096,MTAB&T,TOLL,,-,-,01:22:39,VNB,007,-,($11.19),Y,BUSINESS,N,$1254.98
09/05/2023,09/05/2023,02212261422,MTAB&T,TOLL,,-,-,00:43:06,VNB,008,-,($11.19),Y,BUSINESS,N,$1266.17
09/05/2023,09/04/2023,P46SKT-NJ,MTAB&T,TOLL,,-,-,20:09:35,VNB,015,-,($11.19),Y,BUSINESS,N,$1277.36
09/05/2023,09/04/2023,02212261422,MTAB&T,TOLL,,-,-,19:48:29,VNB,021,-,($11.19),Y,BUSINESS,N,$1288.55
09/05/2023,09/03/2023,02214781099,NYSTA,TOLL,19:24:07,41 ,02E,19:45:39,39 ,11E,2L,($1.59),Y,BUSINESS,N,$1299.74
09/05/2023,09/03/2023,02214781099,NYSTA,TOLL,17:41:31,47 ,99E,17:41:31,46 ,03E,2L,($0.83),Y,BUSINESS,N,$1301.33
09/05/2023,09/03/2023,02214781099,NYSTA,TOLL,17:50:22,46 ,99E,17:50:22,45 ,02E,2L,($0.59),Y,BUSINESS,N,$1302.16
09/05/2023,09/03/2023,02214781099,NYSTA,TOLL,17:58:48,45 ,99E,17:58:48,44 ,04E,2L,($0.20),Y,BUSINESS,N,$1302.75
09/05/2023,09/05/2023,02212261422,GSP,TOLL,,-,-,07:21:15,BRS,01S,1,($0.70),Y,BUSINESS,N,$1302.95
09/05/2023,09/05/2023,02214781096,NJTP,TOLL,01:32:43,13 ,16E,01:48:45,9  ,12X,1,($3.15),Y,BUSINESS,N,$1303.65
09/05/2023,09/05/2023,02214781099,GSP,TOLL,,-,-,00:00:03,BRS,04S,1,($0.70),Y,BUSINESS,N,$1306.80
09/05/2023,09/04/2023,02214781099,GSP,TOLL,,-,-,21:57:45,BRN,04N,1,($0.70),Y,BUSINESS,N,$1307.50
09/04/2023,09/04/2023,02214781099,GSP,TOLL,,-,-,22:06:36,ASP,07N,1,($2.02),Y,BUSINESS,N,$1308.20
09/04/2023,09/04/2023,02214781095,GSP,TOLL,,-,-,20:00:03,BRS,04S,1,($0.70),Y,BUSINESS,N,$1310.22
09/04/2023,09/04/2023,02214781095,GSP,TOLL,,-,-,19:32:18,RAS,13S,1,($2.02),Y,BUSINESS,N,$1310.92
09/04/2023,09/04/2023,02212261422,GSP,TOLL,,-,-,18:54:58,ASP,11N,1,($2.02),Y,BUSINESS,N,$1312.94
09/04/2023,09/04/2023,02214781095,NJTP,TOLL,17:29:40,11 ,05E,17:40:33,13A,12X,1,($2.39),Y,BUSINESS,N,$1314.96
09/04/2023,09/04/2023,02212261422,GSP,TOLL,,-,-,18:43:38,LWN,02N,1,($0.70),Y,BUSINESS,N,$1317.35
09/04/2023,09/04/2023,02214781092,GSP,TOLL,,-,-,16:39:20,TRV,10S,1,($1.01),Y,BUSINESS,N,$1318.05
09/04/2023,09/04/2023,P46SKT-NJ,MTAB&T,TOLL,,-,-,00:54:27,VNB,007,-,($11.19),Y,BUSINESS,N,$1319.06
09/04/2023,09/03/2023,P46SKT-NJ,PANYNJ,TOLL,,-,-,22:49:46,HT ,08,-,($12.75),Y,BUSINESS,N,$1330.25
09/04/2023,09/03/2023,02214781096,PANYNJ,TOLL,,-,-,18:42:24,OBX,02,-,($14.75),Y,BUSINESS,N,$1343.00
09/04/2023,09/03/2023,02214781096,MTAB&T,TOLL,,-,-,19:05:38,VNB,015,-,($11.19),Y,BUSINESS,N,$1357.75
09/04/2023,09/04/2023,02212261422,GSP,TOLL,,-,-,06:50:48,BRS,01S,1,($0.70),Y,BUSINESS,N,$1368.94
09/04/2023,09/04/2023,02214781099,GSP,TOLL,,-,-,00:34:48,BRS,02S,1,($0.70),Y,BUSINESS,N,$1369.64
09/04/2023,09/04/2023,02214781099,GSP,TOLL,,-,-,00:09:22,RAS,14S,1,($2.02),Y,BUSINESS,N,$1370.34
09/04/2023,09/03/2023,02214781091,GSP,TOLL,,-,-,22:37:19,LWS,01S,1,($0.70),Y,BUSINESS,N,$1372.36
09/03/2023,09/03/2023,02214781091,GSP,TOLL,,-,-,20:02:25,ASP,12N,1,($2.02),Y,BUSINESS,N,$1373.06
09/03/2023,09/03/2023,02212261422,GSP,TOLL,,-,-,18:34:34,LWN,01N,1,($0.70),Y,BUSINESS,N,$1375.08
09/03/2023,08/07/2023,Z353593-NJ,GSP,TOLL,,-,-,19:56:31,RAS,13s,1,($2.02),Y,BUSINESS,N,$1375.78
09/03/2023,09/03/2023,02212261422,GSP,TOLL,,-,-,08:05:06,BRS,01S,1,($0.70),Y,BUSINESS,N,$1377.80
09/03/2023,09/02/2023,02214781096,MTAB&T,TOLL,,-,-,23:44:15,VNB,007,-,($11.19),Y,BUSINESS,N,$1378.50
09/03/2023,09/01/2023,G53RRF-NJ,GSP,TOLL,,-,-,00:58:38,RAS,12s,1,($2.02),Y,BUSINESS,N,$1389.69
09/03/2023,09/03/2023,02214781096,NJTP,TOLL,23:53:48,13 ,15E,00:07:46,9  ,12X,1,($4.20),Y,BUSINESS,N,$1391.71
09/03/2023,08/08/2023,G53RRF-NJ,NJTP,TOLL,,-,-,18:18:26,16W,06w,1,($5.21),Y,BUSINESS,M,$1395.91
09/03/2023,08/08/2023,G53RRF-NJ,GSP,TOLL,,-,-,17:24:17,BEN,04n,1,($0.70),Y,BUSINESS,N,$1401.12
09/03/2023,08/08/2023,Z353593-NJ,GSP,TOLL,,-,-,14:03:32,TRV,05n,1,($1.01),Y,BUSINESS,N,$1401.82
09/02/2023,08/08/2023,Z353593-NJ,NJTP,TOLL,,-,-,21:38:14,18W,09w,1,($5.14),Y,BUSINESS,M,$1402.83
09/02/2023,08/08/2023,Z353593-NJ,GSP,TOLL,,-,-,13:05:23,TRV,14s,1,($1.01),Y,BUSINESS,N,$1407.97
09/02/2023,09/02/2023,02214781096,MTAB&T,TOLL,,-,-,12:37:09,VNB,014,-,($11.19),Y,BUSINESS,N,$1408.98
09/02/2023,09/02/2023,02214781096,PANYNJ,TOLL,,-,-,12:29:06,GB ,04,-,($14.75),Y,BUSINESS,N,$1420.17
09/02/2023,09/01/2023,H21SHK-NJ,MTAB&T,TOLL,,-,-,01:42:55,RKB,001,-,($11.19),Y,BUSINESS,N,$1434.92
09/02/2023,08/29/2023,K13SFN-NJ,MTAB&T,TOLL,,-,-,23:44:00,VNB,002,-,($11.19),Y,BUSINESS,N,$1446.11
09/02/2023,08/29/2023,K13SFN-NJ,MTAB&T,TOLL,,-,-,22:00:01,VNB,021,-,($11.19),Y,BUSINESS,N,$1457.30
09/02/2023,08/29/2023,K13SFN-NJ,MTAB&T,TOLL,,-,-,19:44:30,VNB,002,-,($11.19),Y,BUSINESS,N,$1468.49
09/02/2023,08/28/2023,P47SKT-NJ,MTAB&T,TOLL,,-,-,00:36:26,VNB,003,-,($11.19),Y,BUSINESS,N,$1479.68
09/02/2023,08/27/2023,P47SKT-NJ,MTAB&T,TOLL,,-,-,18:30:00,VNB,015,-,($11.19),Y,BUSINESS,N,$1490.87
09/02/2023,09/01/2023,02214781096,MTAB&T,TOLL,,-,-,21:47:34,VNB,003,-,($11.19),Y,BUSINESS,N,$1502.06
09/02/2023,09/01/2023,02214781096,NJTP,TOLL,21:57:22,13 ,17E,22:12:10,9  ,09X,1,($3.15),Y,BUSINESS,N,$1513.25
09/02/2023,08/06/2023,Z378141-NJ,GSP,TOLL,,-,-,10:42:20,LWN,01n,1,($0.70),Y,BUSINESS,N,$1516.40
09/02/2023,08/06/2023,Z378147-NJ,GSP,TOLL,,-,-,17:19:26,LWS,02s,1,($0.70),Y,BUSINESS,N,$1517.10
09/02/2023,08/31/2023,02214781095,PTC,TOLL,09:41:12,MAV,02,09:57:53,POC,05,-,($3.10),Y,BUSINESS,N,$1517.80
09/02/2023,08/06/2023,Z378141-NJ,GSP,TOLL,,-,-,10:53:11,ASP,11n,1,($2.02),Y,BUSINESS,N,$1520.90
09/02/2023,08/06/2023,Z378147-NJ,GSP,TOLL,,-,-,16:46:53,RAS,13s,1,($2.02),Y,BUSINESS,N,$1522.92
09/02/2023,08/31/2023,02214781095,PTC,TOLL,20:15:59,903,04,21:24:24,NES,07,-,($13.60),Y,BUSINESS,N,$1524.94
09/02/2023,08/31/2023,02214781095,PTC,TOLL,08:48:48,LEV,03,09:13:27,903,08,-,($4.40),Y,BUSINESS,N,$1538.54
09/02/2023,08/31/2023,02214781095,PTC,TOLL,09:14:48,903,04,09:37:26,MAV,04,-,($1.80),Y,BUSINESS,N,$1542.94
09/02/2023,08/31/2023,02214781095,PTC,TOLL,,-,-,07:43:45,DRB,01,-,($6.90),Y,BUSINESS,N,$1544.74
09/02/2023,08/31/2023,02214781095,PTC,TOLL,07:48:43,NES,05,08:37:14,LEV,07,-,($9.40),Y,BUSINESS,N,$1551.64
09/02/2023,09/01/2023,02214781101,SJ,TOLL,,-,-,12:26:50,MTB,01,2,($2.50),Y,BUSINESS,N,$1561.04
09/02/2023,08/06/2023,Z378141-NJ,NJTP,TOLL,,-,-,18:36:40,16W,12w,1,($5.21),Y,BUSINESS,M,$1563.54
09/01/2023,08/09/2023,G53RRF-NJ,GSP,TOLL,,-,-,00:33:30,RAS,14s,1,($2.02),Y,BUSINESS,N,$1568.75
09/01/2023,09/01/2023,02212261422,GSP,TOLL,,-,-,16:03:13,LWN,04N,1,($0.70),Y,BUSINESS,N,$1570.77
09/01/2023,08/06/2023,Z378141-NJ,NJTP,TOLL,17:51:19,-,-,17:51:19,19W,01s,1,($2.08),Y,BUSINESS,N,$1571.47
09/01/2023,09/01/2023,02214781101,GSP,TOLL,,-,-,14:19:00,NGR,07N,1,($2.02),Y,BUSINESS,N,$1573.55
09/01/2023,09/01/2023,02214781101,GSP,TOLL,,-,-,13:31:38,CMY,07N,1,($2.02),Y,BUSINESS,N,$1575.57
09/01/2023,08/25/2023,H21SHK-NJ,MTAB&T,TOLL,,-,-,00:33:39,VNB,002,-,($11.19),Y,BUSINESS,N,$1577.59
09/01/2023,08/24/2023,H21SHK-NJ,MTAB&T,TOLL,,-,-,19:05:54,VNB,014,-,($11.19),Y,BUSINESS,N,$1588.78
09/01/2023,09/01/2023,02214781101,GSP,TOLL,,-,-,11:17:11,GEG,05S,1,($2.02),Y,BUSINESS,N,$1599.97
09/01/2023,09/01/2023,02214781094,GSP,TOLL,,-,-,11:45:10,BRN,01N,1,($0.70),Y,BUSINESS,N,$1601.99
09/01/2023,09/01/2023,02214781101,GSP,TOLL,,-,-,10:47:10,BAR,08S,1,($2.02),Y,BUSINESS,N,$1602.69
09/01/2023,08/31/2023,02212261422,PANYNJ,TOLL,,-,-,20:50:35,GB ,04,-,($12.75),Y,BUSINESS,N,$1604.71
09/01/2023,09/01/2023,02212261422,GSP,TOLL,,-,-,01:53:46,LWN,04N,1,($0.70),Y,BUSINESS,N,$1617.46
09/01/2023,09/01/2023,02212261422,GSP,TOLL,,-,-,01:25:58,BRS,01S,1,($0.70),Y,BUSINESS,N,$1618.16
09/01/2023,09/01/2023,02212261422,GSP,TOLL,,-,-,07:34:37,LWS,04S,1,($0.70),Y,BUSINESS,N,$1618.86
09/01/2023,09/01/2023,02212261422,MTAB&T,TOLL,,-,-,00:36:07,VNB,008,-,($11.19),Y,BUSINESS,N,$1619.56
09/01/2023,08/31/2023,02212261422,MTAB&T,TOLL,,-,-,20:59:50,VNB,015,-,($11.19),Y,BUSINESS,N,$1630.75
09/01/2023,08/06/2023,Z378141-NJ,NJTP,TOLL,18:46:05,-,-,18:46:05,19W,04n,1,($2.08),Y,BUSINESS,N,$1641.94
09/01/2023,09/01/2023,02214781094,GSP,TOLL,,-,-,04:45:52,BRS,02S,1,($0.70),Y,BUSINESS,N,$1644.02
09/01/2023,08/31/2023,02214781095,NJTP,TOLL,21:32:34,6  ,09E,21:44:15,7A ,12X,1,($2.31),Y,BUSINESS,N,$1644.72
08/31/2023,08/31/2023,02212261422,NJTP,TOLL,20:38:12,11 ,05E,20:48:23,13 ,10X,1,($1.80),Y,BUSINESS,N,$1647.03
08/31/2023,08/31/2023,02214781101,GSP,TOLL,,-,-,19:27:31,TRV,06N,1,($1.01),Y,BUSINESS,N,$1648.83
08/31/2023,08/31/2023,02212261422,GSP,TOLL,,-,-,20:05:31,ASP,12N,1,($2.02),Y,BUSINESS,N,$1649.84
08/31/2023,08/31/2023,02212261422,GSP,TOLL,,-,-,19:55:11,BRN,04N,1,($0.70),Y,BUSINESS,N,$1651.86
08/31/2023,08/06/2023,Z378141-NJ,NJTP,TOLL,11:59:10,-,-,11:59:10,19W,03n,1,($2.08),Y,BUSINESS,N,$1652.56
08/31/2023,08/06/2023,Z378141-NJ,NJTP,TOLL,,-,-,11:34:05,16W,11w,1,($5.21),Y,BUSINESS,M,$1654.64
08/31/2023,08/29/2023,K13SFN-NJ,PANYNJ,TOLL,,-,-,16:13:27,OBX,08,-,($14.75),Y,BUSINESS,N,$1659.85
08/31/2023,08/27/2023,A16NUB-NJ,PANYNJ,TOLL,,-,-,14:34:12,OBX,02,-,($14.75),Y,BUSINESS,N,$1674.60
08/31/2023,08/27/2023,P47SKT-NJ,PANYNJ,TOLL,,-,-,17:34:50,OBX,04,-,($14.75),Y,BUSINESS,N,$1689.35
08/31/2023,08/31/2023,02214781094,GSP,TOLL,,-,-,14:08:45,BRN,01N,1,($0.70),Y,BUSINESS,N,$1704.10
08/31/2023,08/31/2023,02214781094,GSP,TOLL,,-,-,14:18:11,ASP,10N,1,($2.02),Y,BUSINESS,N,$1704.80
08/31/2023,08/24/2023,G36RMC-NJ,MTAB&T,TOLL,,-,-,16:36:30,CBB,001,-,($5.60),Y,BUSINESS,N,$1706.82
08/31/2023,08/31/2023,02214781095,NJTP,TOLL,07:30:19,7A ,000,07:40:18,6  ,08X,1,($3.08),Y,BUSINESS,N,$1712.42
08/31/2023,08/24/2023,B52RCN-NJ,MTAB&T,TOLL,,-,-,13:54:19,QMT,016,-,($11.19),Y,BUSINESS,N,$1715.50
08/31/2023,08/31/2023,02214781094,GSP,TOLL,,-,-,04:41:55,BRS,02S,1,($0.70),Y,BUSINESS,N,$1726.69
08/31/2023,08/28/2023,02214781095,DelDOT,TOLL,,-,-,08:41:01,D95,40,-,($4.00),Y,BUSINESS,N,$1727.39
08/31/2023,08/29/2023,02214781101,PTC,TOLL,,-,-,16:25:31,DRB,02,-,($6.90),Y,BUSINESS,N,$1731.39
08/30/2023,08/30/2023,02214781101,GSP,TOLL,,-,-,19:44:11,NGR,07N,1,($2.02),Y,BUSINESS,N,$1738.29
08/30/2023,08/30/2023,02214781101,GSP,TOLL,,-,-,19:15:42,CMY,07N,1,($2.02),Y,BUSINESS,N,$1740.31
08/30/2023,08/30/2023,02214781101,GSP,TOLL,,-,-,17:06:16,BAR,08S,1,($2.02),Y,BUSINESS,N,$1742.33
08/30/2023,08/30/2023,02214781101,GSP,TOLL,,-,-,17:35:40,GEG,05S,1,($2.02),Y,BUSINESS,N,$1744.35
08/30/2023,08/30/2023,02214781094,GSP,TOLL,,-,-,14:08:01,ASP,10N,1,($2.02),Y,BUSINESS,N,$1746.37
08/30/2023,08/30/2023,02214781094,GSP,TOLL,,-,-,14:30:28,RAS,01S,1,($2.02),Y,BUSINESS,N,$1748.39
08/30/2023,08/29/2023,02214781096,MTAB&T,TOLL,,-,-,23:08:02,TNB,007,-,($11.19),Y,BUSINESS,N,$1750.41
08/30/2023,08/29/2023,02214781096,MTAB&T,TOLL,,-,-,22:52:50,TNB,001,-,($11.19),Y,BUSINESS,N,$1761.60
08/30/2023,08/29/2023,02214781091,MTAB&T,TOLL,,-,-,16:31:46,VNB,021,-,($11.19),Y,BUSINESS,N,$1772.79
08/30/2023,08/30/2023,02214781094,GSP,TOLL,,-,-,04:51:41,BRS,02S,1,($0.70),Y,BUSINESS,N,$1783.98
08/30/2023,08/30/2023,02214781091,GSP,TOLL,,-,-,00:10:19,RAS,08S,1,($2.02),Y,BUSINESS,N,$1784.68
08/29/2023,08/29/2023,02214781101,NJTP,TOLL,19:11:44,6  ,09E,19:32:53,7A ,10X,1,($2.31),Y,BUSINESS,N,$1786.70
08/29/2023,08/29/2023,02212261422,GSP,TOLL,,-,-,21:07:32,LWS,01S,1,($0.70),Y,BUSINESS,N,$1789.01
08/29/2023,08/29/2023,02212261422,GSP,TOLL,,-,-,20:39:54,RAS,15S,1,($2.02),Y,BUSINESS,N,$1789.71
08/29/2023,08/29/2023,02212261422,NJTP,TOLL,18:44:27,18W,09E,18:46:12,16W,10X,1,($1.56),Y,BUSINESS,N,$1791.73
08/29/2023,08/29/2023,02214781101,NJTP,TOLL,16:11:57,7A ,000,16:22:05,6  ,08X,1,($2.31),Y,BUSINESS,N,$1793.29
08/29/2023,08/03/2023,G53RRF-NJ,GSP,TOLL,,-,-,14:20:59,NGR,07n,1,($2.02),Y,BUSINESS,N,$1795.60
08/29/2023,08/29/2023,02214781095,NJTP,TOLL,15:01:18,13A,02E,15:12:32,11 ,14X,1,($1.80),Y,BUSINESS,N,$1797.62
08/29/2023,08/29/2023,02214781095,NJTP,TOLL,13:55:45,16E,21E,14:06:50,13A,20X,1,($3.91),Y,BUSINESS,N,$1799.42
08/29/2023,08/29/2023,02214781091,GSP,TOLL,,-,-,15:46:52,ASP,02N,1,($2.02),Y,BUSINESS,N,$1803.33
08/29/2023,08/29/2023,02214781095,GSP,TOLL,,-,-,15:16:58,RAS,12S,1,($2.02),Y,BUSINESS,N,$1805.35
08/29/2023,08/29/2023,02214781094,GSP,TOLL,,-,-,14:16:21,ASP,10N,1,($2.02),Y,BUSINESS,N,$1807.37
08/29/2023,08/29/2023,02214781095,GSP,TOLL,,-,-,15:53:57,BES,04S,1,($0.70),Y,BUSINESS,N,$1809.39
08/29/2023,08/29/2023,02214781096,PANYNJ,TOLL,,-,-,07:52:18,GB ,02,-,($14.75),Y,BUSINESS,N,$1810.09
08/29/2023,08/29/2023,02212261422,GSP,TOLL,,-,-,13:23:56,BEN,03N,1,($0.70),Y,BUSINESS,N,$1824.84
08/29/2023,08/29/2023,02214781094,GSP,TOLL,,-,-,11:59:55,LWS,04S,1,($0.70),Y,BUSINESS,N,$1825.54
08/29/2023,08/29/2023,02212261422,GSP,TOLL,,-,-,13:57:21,UNI,10N,1,($2.02),Y,BUSINESS,N,$1826.24
08/29/2023,08/29/2023,02214781096,MTAB&T,TOLL,,-,-,08:00:11,VNB,015,-,($11.19),Y,BUSINESS,N,$1828.26
08/29/2023,08/29/2023,02212261422,GSP,TOLL,,-,-,13:27:43,ASP,12N,1,($2.02),Y,BUSINESS,N,$1839.45
08/29/2023,08/29/2023,02214781096,NJTP,TOLL,07:36:08,9  ,04E,07:50:14,13 ,11X,1,($4.20),Y,BUSINESS,N,$1841.47
08/29/2023,08/28/2023,02214781095,PANYNJ,TOLL,,-,-,23:05:54,LT ,10,-,($12.75),Y,BUSINESS,N,$1845.67
08/29/2023,08/28/2023,H25NDU-NJ,PANYNJ,TOLL,,-,-,16:44:52,HT ,04,-,($14.75),Y,BUSINESS,N,$1858.42
08/29/2023,08/28/2023,02214781096,MTAB&T,TOLL,,-,-,20:51:25,VNB,007,-,($11.19),Y,BUSINESS,N,$1873.17
08/29/2023,08/29/2023,02214781094,GSP,TOLL,,-,-,04:53:59,BRS,04S,1,($0.70),Y,BUSINESS,N,$1884.36
08/29/2023,08/29/2023,02214781094,GSP,TOLL,,-,-,04:24:03,RAS,13S,1,($2.02),Y,BUSINESS,N,$1885.06
08/29/2023,08/27/2023,02214781095,DelDOT,TOLL,,-,-,07:06:28,D95,41,-,($4.00),Y,BUSINESS,N,$1887.08
08/29/2023,08/28/2023,02214781096,NJTP,TOLL,21:00:55,13 ,13E,21:16:10,9  ,12X,1,($3.15),Y,BUSINESS,N,$1891.08
08/29/2023,08/27/2023,02214781097,NYNJArpt,EPS,17:07:39,EWM,909,00:31:06,EWM,962,-,$140.00,Y,STANDARD,N,$1966.71
08/28/2023,08/28/2023,02214781095,NJTP,TOLL,16:17:16,11 ,04E,16:37:17,14C,06X,1,($5.90),Y,BUSINESS,N,$1894.23
08/28/2023,08/28/2023,02214781101,GSP,TOLL,,-,-,17:49:36,BAR,08S,1,($2.02),Y,BUSINESS,N,$1900.13
08/28/2023,08/28/2023,02214781095,GSP,TOLL,,-,-,15:32:55,ASP,07N,1,($2.02),Y,BUSINESS,N,$1902.15
08/28/2023,08/28/2023,02214781095,MdTA,TOLL,,-,-,07:59:14,JFK,53,-,($8.00),Y,BUSINESS,N,$1904.17
08/28/2023,08/25/2023,A16NUB-NJ,MTAB&T,TOLL,,-,-,00:53:44,VNB,002,-,($11.19),Y,BUSINESS,N,$1912.17
08/28/2023,08/28/2023,02214781095,MdTA,TOLL,,-,-,07:28:09,FMT,72,-,($4.00),Y,BUSINESS,N,$1923.36
08/28/2023,08/28/2023,02214781095,MdTA,TOLL,,-,-,07:33:11,951,002,-,($1.19),Y,BUSINESS,N,$1927.36
08/28/2023,08/28/2023,02214781094,GSP,TOLL,,-,-,14:55:47,ASP,04N,1,($2.02),Y,BUSINESS,N,$1928.55
08/28/2023,08/24/2023,H21SHK-NJ,PANYNJ,TOLL,,-,-,18:53:51,GB ,02,-,($14.75),Y,BUSINESS,N,$1930.57
08/28/2023,08/24/2023,P46SKT-NJ,PANYNJ,TOLL,,-,-,07:39:45,GWU,02,-,($14.75),Y,BUSINESS,N,$1945.32
08/28/2023,08/28/2023,02214781095,NJTP,TOLL,08:59:03,1  ,18E,10:08:03,7A ,06X,1,($6.64),Y,BUSINESS,N,$1960.07
08/28/2023,08/27/2023,02214781096,PANYNJ,TOLL,,-,-,20:39:08,GB ,02,-,($14.75),Y,BUSINESS,N,$1966.71
08/28/2023,08/27/2023,02214781096,MTAB&T,TOLL,,-,-,21:15:04,VNB,022,-,($11.19),Y,BUSINESS,N,$1981.46
08/27/2023,08/27/2023,02214781096,NJTP,TOLL,20:20:52,9  ,05E,20:36:56,13 ,08X,1,($4.20),Y,BUSINESS,N,$1992.65
08/27/2023,08/27/2023,02214781091,GSP,TOLL,,-,-,21:53:59,BRS,04S,1,($0.70),Y,BUSINESS,N,$1996.85
08/27/2023,08/27/2023,02214781091,GSP,TOLL,,-,-,18:43:18,ASP,11N,1,($2.02),Y,BUSINESS,N,$1997.55
08/27/2023,08/27/2023,02212261422,GSP,TOLL,,-,-,18:41:14,ESS,08S,1,($2.02),Y,BUSINESS,N,$1999.57
08/27/2023,08/27/2023,02212261422,GSP,TOLL,,-,-,19:32:28,LWS,01S,1,($0.70),Y,BUSINESS,N,$2001.59
08/27/2023,08/27/2023,02214781091,GSP,TOLL,,-,-,18:31:14,LWN,02N,1,($0.70),Y,BUSINESS,N,$2002.29
08/27/2023,08/27/2023,02212261422,GSP,TOLL,,-,-,19:04:33,RAS,14S,1,($2.02),Y,BUSINESS,N,$2002.99
08/27/2023,08/26/2023,02214781095,NYSTA,TOLL,,-,-,21:26:21,YK,03S,2L,($1.37),Y,BUSINESS,N,$2005.01
08/27/2023,08/27/2023,02212261422,GSP,TOLL,,-,-,17:16:35,PSS,02S,1,($0.70),Y,BUSINESS,N,$2006.38
08/27/2023,08/27/2023,02212261422,NJTP,TOLL,12:22:25,11 ,06E,12:41:19,16W,07X,1,($7.43),Y,BUSINESS,N,$2007.08
08/27/2023,08/27/2023,02212261422,GSP,TOLL,,-,-,13:19:00,BER,06N,1,($2.02),Y,BUSINESS,N,$2014.51
08/27/2023,08/27/2023,02212261422,GSP,TOLL,,-,-,11:55:53,ASP,12N,1,($2.02),Y,BUSINESS,N,$2016.53
08/27/2023,08/27/2023,02212261422,GSP,TOLL,,-,-,11:44:19,LWN,02N,1,($0.70),Y,BUSINESS,N,$2018.55
08/27/2023,08/27/2023,02214781098,MTAB&T,TOLL,,-,-,02:43:46,QMT,014,-,($11.19),Y,BUSINESS,N,$2019.25
08/27/2023,08/27/2023,02214781096,MTAB&T,TOLL,,-,-,02:23:18,VNB,007,-,($11.19),Y,BUSINESS,N,$2030.44
08/27/2023,08/26/2023,02214781101,MTAB&T,TOLL,,-,-,21:36:43,VNB,007,-,($11.19),Y,BUSINESS,N,$2041.63
08/27/2023,08/27/2023,02214781095,NJTP,TOLL,05:44:28,7A ,000,06:30:16,1  ,16X,1,($6.64),Y,BUSINESS,N,$2052.82
08/27/2023,08/27/2023,02214781095,DRBA,TOLL,,-,-,06:35:04,DMB,04,1,($4.75),Y,BUSINESS,N,$2059.46
08/27/2023,08/27/2023,02214781096,NJTP,TOLL,02:33:02,13 ,13E,02:55:36,8A ,09X,1,($5.21),Y,BUSINESS,N,$2064.21
08/27/2023,08/27/2023,02214781097,NJTP,TOLL,00:35:47,13A,08E,00:47:07,11 ,15X,1,($2.39),Y,BUSINESS,N,$2069.42
08/27/2023,08/27/2023,02214781097,GSP,TOLL,,-,-,01:22:55,LWS,01S,1,($0.70),Y,BUSINESS,N,$2071.81
08/27/2023,08/27/2023,02214781097,GSP,TOLL,,-,-,00:51:12,RAS,13S,1,($2.02),Y,BUSINESS,N,$2072.51
08/27/2023,08/26/2023,02214781095,NJTP,TOLL,22:20:59,13A,04E,22:31:33,11 ,14X,1,($2.39),Y,BUSINESS,N,$2074.53
08/27/2023,08/26/2023,02214781095,NJTP,TOLL,21:53:48,18E,15E,22:04:21,13A,18X,1,($6.85),Y,BUSINESS,N,$2076.92
08/26/2023,08/26/2023,02214781095,GSP,TOLL,,-,-,22:35:23,RAS,13S,1,($2.02),Y,BUSINESS,N,$2083.77
08/26/2023,08/26/2023,02214781101,GSP,TOLL,,-,-,22:17:54,BES,03S,1,($0.70),Y,BUSINESS,N,$2085.79
08/26/2023,08/26/2023,02214781101,GSP,TOLL,,-,-,21:57:18,RAS,15S,1,($2.02),Y,BUSINESS,N,$2086.49
08/26/2023,08/26/2023,02214781098,MTAB&T,TOLL,,-,-,12:54:21,QMT,002,-,($11.19),Y,BUSINESS,N,$2088.51
08/26/2023,08/25/2023,02214781095,NYSTA,TOLL,,-,-,16:34:26,MCB,17S,2L,($6.61),Y,BUSINESS,N,$2099.70
08/26/2023,08/24/2023,02214781099,NYSTA,TOLL,12:31:09,48 ,02E,12:56:37,50 ,03W,2L,($1.55),Y,BUSINESS,N,$2106.31
08/26/2023,08/26/2023,02214781096,MTAB&T,TOLL,,-,-,06:09:12,BWB,006,-,($11.19),Y,BUSINESS,N,$2107.86
08/26/2023,08/26/2023,02214781096,MTAB&T,TOLL,,-,-,04:19:41,TNB,002,-,($11.19),Y,BUSINESS,N,$2119.05
08/26/2023,08/13/2023,Z353593-NJ,NYSTA,TOLL,16:52:39,47 ,12W,17:23:41,50 ,03W,2L,($2.43),Y,BUSINESS,N,$2130.24
08/26/2023,08/25/2023,02214781101,PANYNJ,TOLL,,-,-,17:13:26,OBX,04,-,($14.75),Y,BUSINESS,N,$2132.67
08/26/2023,08/25/2023,02214781101,MTAB&T,TOLL,,-,-,17:37:57,VNB,020,-,($11.19),Y,BUSINESS,N,$2147.42
08/26/2023,08/23/2023,X18NMX-NJ,GSP,TOLL,,-,-,19:42:18,RAS,13s,1,($2.02),Y,BUSINESS,N,$2158.61
08/25/2023,08/23/2023,G53RRF-NJ,GSP,TOLL,,-,-,13:49:14,BAR,07s,1,($2.02),Y,BUSINESS,N,$2160.63
08/25/2023,08/24/2023,02214781099,NYSTA,TOLL,,-,-,13:09:59,GIS,02N,2L,($1.09),Y,BUSINESS,N,$2162.65
08/25/2023,08/25/2023,02214781097,GSP,TOLL,,-,-,16:23:21,ESS,09S,1,($2.02),Y,BUSINESS,N,$2163.74
08/25/2023,08/25/2023,02214781101,GSP,TOLL,,-,-,16:52:19,ASP,12N,1,($2.02),Y,BUSINESS,N,$2165.76
08/25/2023,08/25/2023,02214781095,GSP,TOLL,,-,-,16:03:05,BER,11N,1,($2.02),Y,BUSINESS,N,$2167.78
08/25/2023,08/25/2023,02214781101,GSP,TOLL,,-,-,16:48:25,BEN,05N,1,($0.70),Y,BUSINESS,N,$2169.80
08/25/2023,08/25/2023,02214781095,GSP,TOLL,,-,-,15:31:09,UNI,14N,1,($2.02),Y,BUSINESS,N,$2170.50
08/25/2023,08/25/2023,02214781095,GSP,TOLL,,-,-,14:58:19,EAT,04N,1,($2.02),Y,BUSINESS,N,$2172.52
08/25/2023,08/25/2023,02214781096,PANYNJ,TOLL,,-,-,09:20:04,LT ,10,-,($14.75),Y,BUSINESS,N,$2174.54
08/25/2023,08/25/2023,02214781096,NJTP,TOLL,08:45:26,9  ,06E,09:13:18,16E,01X,1,($9.40),Y,BUSINESS,N,$2189.29
08/25/2023,08/24/2023,02214781096,MTAB&T,TOLL,,-,-,22:03:38,VNB,007,-,($11.19),Y,BUSINESS,N,$2198.69
08/25/2023,08/24/2023,02214781098,MTAB&T,TOLL,,-,-,15:54:43,MPB,004,-,($5.60),Y,BUSINESS,N,$2209.88
08/25/2023,08/24/2023,02214781099,NFBC,TOLL,,-,-,13:34:35,LQ,6,-,($5.00),Y,BUSINESS,N,$2215.48
08/25/2023,08/24/2023,02214781096,NJTP,TOLL,22:13:04,13 ,13E,22:32:54,9  ,12X,1,($3.15),Y,BUSINESS,N,$2220.48
08/25/2023,08/23/2023,X18NMX-NJ,NJTP,TOLL,,-,-,19:38:13,11 ,15w,1,($4.98),Y,BUSINESS,M,$2223.63
08/25/2023,08/25/2023,02214781095,GSP,TOLL,,-,-,00:58:27,LWN,01N,1,($0.70),Y,BUSINESS,N,$2228.61
08/24/2023,08/24/2023,02214781101,GSP,TOLL,,-,-,21:05:55,BRS,02S,1,($0.70),Y,BUSINESS,N,$2229.31
08/24/2023,07/30/2023,Z353601-NJ,GSP,TOLL,,-,-,10:46:03,LWS,02s,1,($0.70),Y,BUSINESS,N,$2230.01
08/24/2023,08/24/2023,02214781095,GSP,TOLL,,-,-,17:24:50,LWS,02S,1,($0.70),Y,BUSINESS,N,$2230.71
08/24/2023,08/24/2023,02214781101,GSP,TOLL,,-,-,17:52:33,BRN,04N,1,($0.70),Y,BUSINESS,N,$2231.41
08/24/2023,08/24/2023,02214781101,GSP,TOLL,,-,-,18:02:23,ASP,11N,1,($2.02),Y,BUSINESS,N,$2232.11
08/24/2023,07/30/2023,Z353601-NJ,GSP,TOLL,,-,-,10:09:03,RAS,15s,1,($2.02),Y,BUSINESS,N,$2234.13
08/24/2023,08/23/2023,02214781092,NYSTA,TOLL,,-,-,21:36:01,HA,02N,2L,($1.37),Y,BUSINESS,N,$2236.15
08/24/2023,08/24/2023,02214781105,GSP,TOLL,,-,-,14:47:34,BEN,01N,1,($0.70),Y,BUSINESS,N,$2237.52
08/24/2023,08/14/2023,Z353593-NJ,NYSTA,TOLL,,-,-,15:38:15,GIN,03S,2L,($1.24),Y,BUSINESS,N,$2238.22
08/24/2023,08/14/2023,Z353593-NJ,NYSTA,TOLL,,-,-,12:51:15,GIS,03N,2L,($1.24),Y,BUSINESS,N,$2239.46
08/24/2023,08/13/2023,Z353593-NJ,NYSTA,TOLL,16:44:18,46 ,99E,16:44:18,47 ,03W,2L,($0.94),Y,BUSINESS,N,$2240.70
08/24/2023,08/13/2023,Z353593-NJ,NYSTA,TOLL,16:35:42,45 ,99E,16:35:42,46 ,03W,2L,($0.67),Y,BUSINESS,N,$2241.64
08/24/2023,08/14/2023,Z353593-NJ,NYSTA,TOLL,17:02:32,44 ,12E,17:37:10,39 ,12E,2L,($3.35),Y,BUSINESS,N,$2242.31
08/24/2023,08/13/2023,Z353593-NJ,NYSTA,TOLL,16:10:19,42 ,02E,16:22:08,44 ,12W,2L,($1.16),Y,BUSINESS,N,$2245.66
08/24/2023,08/14/2023,Z353593-NJ,NYSTA,TOLL,15:57:00,50 ,03E,16:32:23,47 ,12E,2L,($2.43),Y,BUSINESS,N,$2246.82
08/24/2023,08/24/2023,02214781092,GSP,TOLL,,-,-,06:33:07,ESS,08S,1,($2.02),Y,BUSINESS,N,$2249.25
08/24/2023,08/24/2023,02214781092,GSP,TOLL,,-,-,06:18:32,PVK,06S,1,($2.02),Y,BUSINESS,N,$2251.27
08/24/2023,08/24/2023,02214781092,GSP,TOLL,,-,-,06:56:10,RAS,14S,1,($2.02),Y,BUSINESS,N,$2253.29
08/24/2023,08/24/2023,02214781092,GSP,TOLL,,-,-,07:30:16,BES,04S,1,($0.70),Y,BUSINESS,N,$2255.31
08/24/2023,08/23/2023,02214781099,DRJTBC,TOLL,00:00:00,-,-,21:22:45,DWG,01W,1,($1.25),Y,BUSINESS,N,$2256.01
08/23/2023,08/23/2023,02214781091,GSP,TOLL,,-,-,21:51:58,LWS,02S,1,($0.70),Y,BUSINESS,N,$2257.26
08/23/2023,07/28/2023,Z353593-NJ,GSP,TOLL,,-,-,15:44:06,ASP,10n,1,($2.02),Y,BUSINESS,N,$2257.96
08/23/2023,07/30/2023,Z353601-NJ,NJTP,TOLL,,-,-,09:59:09,11 ,13w,1,($6.64),Y,BUSINESS,M,$2259.98
08/23/2023,08/23/2023,02214781092,NJTP,TOLL,18:18:24,11 ,05E,18:49:38,18E,13X,1,($9.61),Y,BUSINESS,N,$2266.62
08/23/2023,08/23/2023,02214781092,GSP,TOLL,,-,-,19:05:39,BER,05N,1,($2.02),Y,BUSINESS,N,$2276.23
08/23/2023,08/23/2023,02214781099,GSP,TOLL,,-,-,19:53:05,ASP,05N,1,($2.02),Y,BUSINESS,N,$2278.25
08/23/2023,08/23/2023,02214781097,GSP,TOLL,,-,-,19:57:16,BER,06N,1,($2.02),Y,BUSINESS,N,$2280.27
08/23/2023,08/23/2023,02214781099,GSP,TOLL,,-,-,19:43:35,BRN,04N,1,($0.70),Y,BUSINESS,N,$2282.29
08/23/2023,08/23/2023,02214781099,GSP,TOLL,,-,-,20:28:48,UNI,10N,1,($2.02),Y,BUSINESS,N,$2282.99
08/23/2023,08/23/2023,02214781097,GSP,TOLL,,-,-,19:35:56,UNR,04N,1,($2.02),Y,BUSINESS,N,$2285.01
08/23/2023,08/23/2023,02214781097,GSP,TOLL,,-,-,18:10:07,ASP,12N,1,($2.02),Y,BUSINESS,N,$2287.03
08/23/2023,08/23/2023,02214781097,GSP,TOLL,,-,-,18:01:29,BRN,04N,1,($0.70),Y,BUSINESS,N,$2289.05
08/23/2023,08/23/2023,02214781091,GSP,TOLL,,-,-,18:55:01,LWN,01N,1,($0.70),Y,BUSINESS,N,$2289.75
08/23/2023,08/23/2023,02214781092,GSP,TOLL,,-,-,17:51:26,BEN,01N,1,($0.70),Y,BUSINESS,N,$2290.45
08/23/2023,08/23/2023,02214781092,GSP,TOLL,,-,-,17:56:05,ASP,11N,1,($2.02),Y,BUSINESS,N,$2291.15
08/23/2023,08/23/2023,-,NJ E-ZPass,Prepaid Payment,,-,-,12:43:49,-,-,-,$1855.00,Y,-,-,$2293.17
08/23/2023,08/22/2023,02214781096,PANYNJ,TOLL,,-,-,18:56:27,GB ,04,-,($14.75),Y,BUSINESS,N,$438.17
08/23/2023,08/22/2023,02214781096,MTAB&T,TOLL,,-,-,19:07:20,VNB,015,-,($11.19),Y,BUSINESS,N,$452.92
08/23/2023,08/20/2023,G53RRF-NJ,GSP,TOLL,,-,-,02:02:58,RAS,14s,1,($2.02),Y,BUSINESS,N,$464.11
08/23/2023,08/23/2023,02214781091,GSP,TOLL,,-,-,00:20:01,BRS,02S,1,($0.70),Y,BUSINESS,N,$466.13
08/22/2023,08/22/2023,02214781096,NJTP,TOLL,18:40:00,9  ,06E,18:54:23,13 ,09X,1,($3.15),Y,BUSINESS,N,$466.83
08/22/2023,08/18/2023,Z443221-NJ,PANYNJ,TOLL,,-,-,04:04:51,GWL,12,-,($12.75),Y,BUSINESS,N,$469.98
08/22/2023,08/14/2023,Z353593-NJ,NYSTA,TOLL,16:57:01,45 ,99E,16:57:01,44 ,04E,2L,($0.22),Y,BUSINESS,N,$482.73
08/22/2023,08/14/2023,Z353593-NJ,NYSTA,TOLL,16:49:24,46 ,99E,16:49:24,45 ,03E,2L,($0.67),Y,BUSINESS,N,$482.95
08/22/2023,08/14/2023,Z353593-NJ,NYSTA,TOLL,16:40:36,47 ,99E,16:40:36,46 ,03E,2L,($0.94),Y,BUSINESS,N,$483.62
08/22/2023,08/13/2023,Z353593-NJ,NYSTA,TOLL,16:27:52,44 ,99E,16:27:52,45 ,04W,2L,($0.22),Y,BUSINESS,N,$484.56
08/22/2023,08/13/2023,Z353593-NJ,NYSTA,TOLL,,-,-,21:00:12,GIN,02S,2L,($1.24),Y,BUSINESS,N,$484.78
08/22/2023,08/14/2023,Z353593-NJ,PTC,TOLL,,-,-,20:18:17,CLS,2,-,($1.40),Y,BUSINESS,N,$486.02
08/22/2023,08/14/2023,Z353593-NJ,PTC,TOLL,,-,-,20:26:29,KEA,3,-,($1.40),Y,BUSINESS,N,$487.42
08/21/2023,08/21/2023,02214781096,NJTP,TOLL,15:43:03,11 ,10E,15:50:40,9  ,15X,1,($0.96),Y,BUSINESS,N,$488.82
08/21/2023,08/21/2023,02214781096,GSP,TOLL,,-,-,15:24:21,IRS,01S,1,($0.70),Y,BUSINESS,N,$489.78
08/21/2023,08/20/2023,02212261422,NYSTA,TOLL,,-,-,01:01:53,HA,03S,2L,($1.37),Y,BUSINESS,N,$490.48
08/21/2023,08/21/2023,02214781098,MTAB&T,TOLL,,-,-,09:29:22,QMT,002,-,($11.19),Y,BUSINESS,N,$491.85
08/21/2023,08/21/2023,02214781096,GSP,TOLL,,-,-,11:30:30,UNI,09N,1,($2.02),Y,BUSINESS,N,$503.04
08/21/2023,08/21/2023,02214781096,GSP,TOLL,,-,-,11:33:34,IRN,01N,1,($0.70),Y,BUSINESS,N,$505.06
08/21/2023,08/21/2023,02214781096,GSP,TOLL,,-,-,10:47:49,IRS,01S,1,($0.70),Y,BUSINESS,N,$505.76
08/21/2023,08/15/2023,G53RRF-NJ,DRJTBC,TOLL,00:00:00,-,-,11:20:03,T-M,04W,1,($1.25),Y,BUSINESS,N,$506.46
08/21/2023,08/17/2023,H16SHK-NJ,PANYNJ,TOLL,,-,-,13:38:23,OBX,02,-,($12.75),Y,BUSINESS,N,$507.71
08/21/2023,08/20/2023,02214781096,PANYNJ,TOLL,,-,-,19:16:55,GB ,10,-,($14.75),Y,BUSINESS,N,$520.46
08/21/2023,08/21/2023,02214781096,MTAB&T,TOLL,,-,-,01:34:55,VNB,007,-,($11.19),Y,BUSINESS,N,$535.21
08/21/2023,08/20/2023,02214781096,MTAB&T,TOLL,,-,-,19:44:03,VNB,022,-,($11.19),Y,BUSINESS,N,$546.40
08/21/2023,08/15/2023,Z353593-NJ,SJ,TOLL,,-,-,00:15:22,APL,71,2,($1.35),Y,BUSINESS,N,$557.59
08/21/2023,08/21/2023,02214781096,GSP,TOLL,,-,-,06:44:15,IRN,01N,1,($0.70),Y,BUSINESS,N,$558.94
08/21/2023,08/21/2023,02214781096,GSP,TOLL,,-,-,06:41:17,UNI,09N,1,($2.02),Y,BUSINESS,N,$559.64
08/20/2023,08/20/2023,02214781096,NJTP,TOLL,18:54:56,10 ,13E,19:09:58,13 ,11X,1,($3.57),Y,BUSINESS,N,$561.66
08/20/2023,08/20/2023,02212261422,GSP,TOLL,,-,-,16:39:50,LWS,01S,1,($0.70),Y,BUSINESS,N,$565.23
08/20/2023,08/20/2023,02212261422,NJTP,TOLL,14:17:19,7  ,10E,14:42:09,10 ,04X,1,($3.57),Y,BUSINESS,N,$565.93
08/20/2023,08/20/2023,02214781097,GSP,TOLL,,-,-,14:18:50,TRV,10S,1,($1.01),Y,BUSINESS,N,$569.50
08/20/2023,08/20/2023,B52RCN-NJ,MTAB&T,TOLL,,-,-,04:48:09,VNB,002,-,($11.19),Y,BUSINESS,N,$570.51
08/20/2023,08/19/2023,02214781096,PANYNJ,TOLL,,-,-,23:45:20,GB ,02,-,($12.75),Y,BUSINESS,N,$581.70
08/20/2023,08/20/2023,02214781096,MTAB&T,TOLL,,-,-,00:01:36,VNB,022,-,($11.19),Y,BUSINESS,N,$594.45
08/20/2023,08/20/2023,02214781096,NJTP,TOLL,04:56:30,13 ,13E,05:10:31,9  ,09X,1,($4.20),Y,BUSINESS,N,$605.64
08/20/2023,08/20/2023,02212261422,GSP,TOLL,,-,-,02:25:22,LWS,01S,1,($0.70),Y,BUSINESS,N,$609.84
08/20/2023,08/19/2023,02214781096,NJTP,TOLL,23:28:00,9  ,05E,23:42:56,13 ,08X,1,($4.20),Y,BUSINESS,N,$610.54
08/19/2023,08/19/2023,02214781098,PANYNJ,TOLL,,-,-,00:10:54,GB ,02,-,($12.75),Y,BUSINESS,N,$614.74
08/19/2023,08/19/2023,02214781096,MTAB&T,TOLL,,-,-,05:09:12,VNB,008,-,($11.19),Y,BUSINESS,N,$627.49
08/19/2023,08/19/2023,02214781098,MTAB&T,TOLL,,-,-,00:17:59,VNB,020,-,($11.19),Y,BUSINESS,N,$638.68
08/19/2023,08/10/2023,Z353601-NJ,MTAB&T,TOLL,,-,-,18:17:05,VNB,004,-,($11.19),Y,BUSINESS,N,$649.87
08/19/2023,08/13/2023,Z378147-NJ,MTAB&T,TOLL,,-,-,05:12:59,VNB,014,-,($11.19),Y,BUSINESS,N,$661.06
08/19/2023,08/18/2023,02214781098,MTAB&T,TOLL,,-,-,21:21:15,VNB,002,-,($11.19),Y,BUSINESS,N,$672.25
08/19/2023,08/11/2023,B52RCN-NJ,MTAB&T,TOLL,,-,-,17:14:19,VNB,002,-,($11.19),Y,BUSINESS,N,$683.44
08/19/2023,08/18/2023,02214781096,PANYNJ,TOLL,,-,-,14:15:52,GB ,02,-,($12.75),Y,BUSINESS,N,$694.63
08/19/2023,08/18/2023,02214781096,MTAB&T,TOLL,,-,-,14:23:50,VNB,014,-,($11.19),Y,BUSINESS,N,$707.38
08/19/2023,08/08/2023,Z353593-NJ,NYSTA,TOLL,,-,-,22:14:11,NR,03N,2L,($2.16),Y,BUSINESS,N,$718.57
08/19/2023,08/19/2023,02214781096,NJTP,TOLL,05:19:40,13 ,13E,05:33:26,9  ,13X,1,($4.20),Y,BUSINESS,N,$720.73
08/19/2023,08/17/2023,02214781099,DelDOT,TOLL,,-,-,10:02:54,D95,40,-,($4.00),Y,BUSINESS,N,$724.93
08/19/2023,08/19/2023,02214781098,NJTP,TOLL,23:59:30,11 ,04E,00:08:49,13 ,11X,1,($1.80),Y,BUSINESS,N,$728.93
08/18/2023,08/18/2023,02214781098,GSP,TOLL,,-,-,22:09:54,BRS,02S,1,($0.70),Y,BUSINESS,N,$730.73
08/18/2023,08/18/2023,02214781098,GSP,TOLL,,-,-,21:43:01,RAS,15S,1,($2.02),Y,BUSINESS,N,$731.43
08/18/2023,08/18/2023,02214781096,NJTP,TOLL,13:57:52,9  ,06E,14:13:37,13 ,11X,1,($3.15),Y,BUSINESS,N,$733.45
08/18/2023,08/18/2023,02214781098,MTAB&T,TOLL,,-,-,11:43:12,QMT,015,-,($11.19),Y,BUSINESS,N,$736.60
08/18/2023,08/18/2023,02212261422,GSP,TOLL,,-,-,13:37:55,UNI,15N,1,($2.02),Y,BUSINESS,N,$747.79
08/18/2023,08/18/2023,02214781098,MTAB&T,TOLL,,-,-,07:32:40,QMT,002,-,($11.19),Y,BUSINESS,N,$749.81
08/18/2023,08/18/2023,02212261422,GSP,TOLL,,-,-,13:05:51,ASP,12N,1,($2.02),Y,BUSINESS,N,$761.00
08/18/2023,08/18/2023,02212261422,GSP,TOLL,,-,-,13:01:20,BEN,04N,1,($0.70),Y,BUSINESS,N,$763.02
08/18/2023,08/18/2023,02214781096,NJTP,TOLL,11:07:00,11 ,09E,11:15:44,9  ,12X,1,($0.96),Y,BUSINESS,N,$763.72
08/18/2023,08/14/2023,Z353593-NJ,SJ,TOLL,,-,-,22:41:19,APL,62,2,($1.35),Y,BUSINESS,N,$764.68
08/18/2023,08/18/2023,02214781096,GSP,TOLL,,-,-,10:49:47,IRS,01S,1,($0.70),Y,BUSINESS,N,$766.03
08/18/2023,08/18/2023,02214781096,GSP,TOLL,,-,-,08:16:32,IRN,01N,1,($0.70),Y,BUSINESS,N,$766.73
08/18/2023,08/18/2023,02214781096,GSP,TOLL,,-,-,08:12:57,UNI,13N,1,($2.02),Y,BUSINESS,N,$767.43
08/18/2023,08/10/2023,G53RRF-NJ,MTAB&T,TOLL,,-,-,22:38:18,RKM,002,-,($11.19),Y,BUSINESS,N,$769.45
08/18/2023,08/07/2023,Z353593-NJ,MTAB&T,TOLL,,-,-,19:32:23,VNB,002,-,($11.19),Y,BUSINESS,N,$780.64
08/18/2023,08/07/2023,Z353593-NJ,MTAB&T,TOLL,,-,-,13:33:55,HCT,002,-,($11.19),Y,BUSINESS,N,$791.83
08/18/2023,08/06/2023,Z378141-NJ,MTAB&T,TOLL,,-,-,19:28:52,TNB,007,-,($11.19),Y,BUSINESS,N,$803.02
08/18/2023,08/17/2023,02214781096,MTAB&T,TOLL,,-,-,20:06:23,VNB,007,-,($11.19),Y,BUSINESS,N,$814.21
08/18/2023,08/17/2023,02214781096,MTAB&T,TOLL,,-,-,10:43:31,VNB,014,-,($11.19),Y,BUSINESS,N,$825.40
08/18/2023,08/09/2023,J49PCA-NJ,FTE,TOLL,,-,-,13:43:04,A60,63S,-,($0.33),Y,BUSINESS,N,$836.59
08/18/2023,08/09/2023,J49PCA-NJ,FTE,TOLL,,-,-,13:16:32,A40,44S,-,($0.33),Y,BUSINESS,N,$836.92
08/18/2023,08/09/2023,J49PCA-NJ,FTE,TOLL,,-,-,13:12:59,A60,66S,-,($0.33),Y,BUSINESS,N,$837.25
08/17/2023,08/17/2023,02214781096,NJTP,TOLL,20:20:28,13 ,15E,20:36:50,9  ,12X,1,($3.15),Y,BUSINESS,N,$837.58
08/17/2023,08/17/2023,02214781099,MdTA,TOLL,,-,-,09:48:01,JFK,54,-,($8.00),Y,BUSINESS,N,$840.73
08/17/2023,08/09/2023,J49PCA-NJ,FTE,TOLL,,-,-,02:38:26,S40,42S,-,($0.47),Y,BUSINESS,N,$848.73
08/17/2023,08/09/2023,J49PCA-NJ,FTE,TOLL,,-,-,02:35:59,S30,21S,-,($0.23),Y,BUSINESS,N,$849.20
08/17/2023,08/09/2023,J49PCA-NJ,FTE,TOLL,,-,-,02:34:59,S20,13S,-,($0.23),Y,BUSINESS,N,$849.43
08/17/2023,08/17/2023,02214781096,PANYNJ,TOLL,,-,-,10:24:40,OBX,02,-,($12.75),Y,BUSINESS,N,$849.66
08/17/2023,08/17/2023,02214781092,MTAB&T,TOLL,,-,-,00:13:22,VNB,003,-,($11.19),Y,BUSINESS,N,$862.41
08/17/2023,08/16/2023,02214781092,MTAB&T,TOLL,,-,-,21:29:09,VNB,021,-,($11.19),Y,BUSINESS,N,$873.60
08/17/2023,08/17/2023,02214781091,GSP,TOLL,,-,-,15:42:51,LWN,02N,1,($0.70),Y,BUSINESS,N,$884.79
08/17/2023,08/16/2023,02214781096,MTAB&T,TOLL,,-,-,16:16:36,VNB,008,-,($11.19),Y,BUSINESS,N,$885.49
08/17/2023,08/17/2023,02214781099,NJTP,TOLL,10:17:57,1  ,17E,12:03:01,8  ,03X,1,($5.57),Y,BUSINESS,N,$896.68
08/17/2023,08/16/2023,02214781096,MTAB&T,TOLL,,-,-,08:39:39,VNB,020,-,($11.19),Y,BUSINESS,N,$902.25
08/17/2023,08/17/2023,02214781098,PANYNJ,TOLL,,-,-,01:45:41,GWU,04,-,($12.75),Y,BUSINESS,N,$913.44
08/17/2023,08/15/2023,02214781096,MTAB&T,TOLL,,-,-,18:40:28,VNB,008,-,($11.19),Y,BUSINESS,N,$926.19
08/17/2023,08/15/2023,02214781096,MTAB&T,TOLL,,-,-,11:06:49,VNB,021,-,($11.19),Y,BUSINESS,N,$937.38
08/17/2023,08/14/2023,02214781096,MTAB&T,TOLL,,-,-,22:51:24,VNB,009,-,($11.19),Y,BUSINESS,N,$948.57
08/17/2023,08/17/2023,02214781098,MTAB&T,TOLL,,-,-,01:58:06,TNB,007,-,($11.19),Y,BUSINESS,N,$959.76
08/17/2023,08/14/2023,02214781096,MTAB&T,TOLL,,-,-,07:53:58,VNB,020,-,($11.19),Y,BUSINESS,N,$970.95
08/17/2023,08/11/2023,02214781096,MTAB&T,TOLL,,-,-,08:00:34,VNB,020,-,($11.19),Y,BUSINESS,N,$982.14
08/17/2023,08/11/2023,02212261422,MTAB&T,TOLL,,-,-,00:25:50,VNB,003,-,($11.19),Y,BUSINESS,N,$993.33
08/17/2023,08/16/2023,02214781092,PANYNJ,TOLL,,-,-,21:14:28,OBX,08,-,($12.75),Y,BUSINESS,N,$1004.52
08/17/2023,08/10/2023,02214781096,MTAB&T,TOLL,,-,-,18:37:01,VNB,007,-,($11.19),Y,BUSINESS,N,$1017.27
08/17/2023,08/16/2023,02214781097,PANYNJ,TOLL,,-,-,19:27:41,GWL,12,-,($14.75),Y,BUSINESS,N,$1028.46
08/17/2023,08/10/2023,02214781096,MTAB&T,TOLL,,-,-,08:02:13,VNB,020,-,($11.19),Y,BUSINESS,N,$1043.21
08/17/2023,08/12/2023,02214781096,MTAB&T,TOLL,,-,-,04:20:31,VNB,008,-,($11.19),Y,BUSINESS,N,$1054.40
08/17/2023,08/16/2023,02214781098,MTAB&T,TOLL,,-,-,16:17:07,RKB,003,-,($11.19),Y,BUSINESS,N,$1065.59
08/17/2023,08/11/2023,02214781096,MTAB&T,TOLL,,-,-,22:09:55,VNB,020,-,($11.19),Y,BUSINESS,N,$1076.78
08/17/2023,08/17/2023,02214781097,NJTP,TOLL,01:54:05,16E,22E,02:16:24,11 ,14X,1,($5.57),Y,BUSINESS,N,$1087.97
08/17/2023,08/15/2023,02214781099,DelDOT,TOLL,,-,-,19:20:49,D95,41,-,($4.00),Y,BUSINESS,N,$1093.54
08/17/2023,08/17/2023,02214781098,NJTP,TOLL,00:53:41,9  ,05E,01:20:05,16E,02X,1,($7.05),Y,BUSINESS,N,$1097.54
08/17/2023,08/17/2023,02214781097,GSP,TOLL,,-,-,02:20:29,RAS,13S,1,($2.02),Y,BUSINESS,N,$1104.59
08/17/2023,08/17/2023,02214781097,NJTP,TOLL,,-,-,01:22:56,17,03S,1,($2.99),Y,BUSINESS,N,$1106.61
08/17/2023,08/17/2023,02214781097,GSP,TOLL,,-,-,03:04:49,BRS,02S,1,($0.70),Y,BUSINESS,N,$1109.60
08/17/2023,08/17/2023,02214781091,GSP,TOLL,,-,-,01:04:29,RAS,14S,1,($2.02),Y,BUSINESS,N,$1110.30
08/17/2023,08/17/2023,02214781092,GSP,TOLL,,-,-,00:53:42,BES,01S,1,($0.70),Y,BUSINESS,N,$1112.32
08/17/2023,08/17/2023,02214781091,GSP,TOLL,,-,-,01:37:38,LWS,04S,1,($0.70),Y,BUSINESS,N,$1113.02
08/17/2023,08/17/2023,02214781091,GSP,TOLL,,-,-,00:24:52,PVK,07S,1,($2.02),Y,BUSINESS,N,$1113.72
08/17/2023,08/17/2023,02214781091,GSP,TOLL,,-,-,00:40:10,ESS,09S,1,($2.02),Y,BUSINESS,N,$1115.74
08/17/2023,08/17/2023,02214781092,GSP,TOLL,,-,-,00:34:39,RAS,14S,1,($2.02),Y,BUSINESS,N,$1117.76
08/17/2023,08/16/2023,02214781098,NJTP,TOLL,21:25:40,9  ,06E,21:34:46,11 ,26X,1,($0.96),Y,BUSINESS,N,$1119.78
08/17/2023,08/16/2023,02214781097,NJTP,TOLL,18:50:12,11 ,06E,19:10:24,18E,13X,1,($7.21),Y,BUSINESS,N,$1120.74
08/16/2023,08/16/2023,02214781091,GSP,TOLL,,-,-,21:12:37,BER,07N,1,($2.02),Y,BUSINESS,N,$1127.95
08/16/2023,08/16/2023,02214781091,GSP,TOLL,,-,-,20:54:35,UNI,16N,1,($2.02),Y,BUSINESS,N,$1129.97
08/16/2023,08/16/2023,02214781092,GSP,TOLL,,-,-,20:50:25,ASP,11N,1,($2.02),Y,BUSINESS,N,$1131.99
08/16/2023,08/16/2023,02214781092,GSP,TOLL,,-,-,20:46:10,BEN,03N,1,($0.70),Y,BUSINESS,N,$1134.01
08/16/2023,08/16/2023,02214781091,GSP,TOLL,,-,-,20:09:45,ASP,11N,1,($2.02),Y,BUSINESS,N,$1134.71
08/16/2023,08/16/2023,02214781091,GSP,TOLL,,-,-,19:57:28,LWN,01N,1,($0.70),Y,BUSINESS,N,$1136.73
08/16/2023,08/16/2023,02214781098,NJTP,TOLL,18:09:06,18E,16E,18:29:48,12 ,16X,1,($8.81),Y,BUSINESS,N,$1137.43
08/16/2023,08/16/2023,02214781097,GSP,TOLL,,-,-,18:27:37,ASP,11N,1,($2.02),Y,BUSINESS,N,$1146.24
08/16/2023,08/16/2023,02214781097,GSP,TOLL,,-,-,18:18:29,BRN,04N,1,($0.70),Y,BUSINESS,N,$1148.26
08/16/2023,08/16/2023,02214781096,NJTP,TOLL,16:37:30,13 ,18E,16:59:16,9  ,15X,1,($4.20),Y,BUSINESS,N,$1148.96
08/16/2023,08/16/2023,02214781096,PANYNJ,TOLL,,-,-,08:29:51,GB ,02,-,($14.75),Y,BUSINESS,N,$1153.16
08/16/2023,08/13/2023,Z378147-NJ,PANYNJ,TOLL,,-,-,04:58:08,OBX,04,-,($12.75),Y,BUSINESS,N,$1167.91
08/16/2023,08/07/2023,J49PCA-NJ,FTE,TOLL,,-,-,20:46:46,D41,42S,-,($0.28),Y,BUSINESS,N,$1180.66
08/16/2023,08/07/2023,J49PCA-NJ,FTE,TOLL,,-,-,20:45:35,D55,52S,-,($0.28),Y,BUSINESS,N,$1180.94
08/16/2023,08/08/2023,Z378141-NJ,NYSTA,TOLL,,-,-,06:41:12,HA,02S,2L,($1.54),Y,BUSINESS,N,$1181.22
08/16/2023,08/16/2023,02214781096,NJTP,TOLL,08:13:01,9  ,06E,08:27:48,13 ,10X,1,($4.20),Y,BUSINESS,N,$1182.76
08/16/2023,08/07/2023,Z378141-NJ,NYSTA,TOLL,,-,-,19:34:10,YK,03N,2L,($1.54),Y,BUSINESS,N,$1186.96
08/16/2023,08/13/2023,U66RYG-NJ,VDOT,TOLL,20:11:20,GRS,1,20:17:25,123,2,-,($7.55),Y,BUSINESS,N,$1188.50
08/15/2023,08/15/2023,02214781099,DRBA,TOLL,,-,-,19:09:34,DMB,01,1,($4.75),Y,BUSINESS,N,$1196.05
08/15/2023,08/15/2023,02214781099,NJTP,TOLL,18:10:46,7A ,000,19:04:39,1  ,15X,1,($6.64),Y,BUSINESS,N,$1200.80
08/15/2023,08/15/2023,02214781096,NJTP,TOLL,18:52:29,13 ,16E,19:06:27,9  ,12X,1,($3.15),Y,BUSINESS,N,$1207.44
08/15/2023,08/15/2023,02214781096,PANYNJ,TOLL,,-,-,10:58:57,GB ,02,-,($12.75),Y,BUSINESS,N,$1210.59
08/15/2023,08/15/2023,02214781096,NJTP,TOLL,10:42:26,9  ,04E,10:56:50,13 ,07X,1,($3.15),Y,BUSINESS,N,$1223.34
08/15/2023,08/07/2023,J49PCA-NJ,FTE,TOLL,,-,-,00:24:23,D39,25S,-,($0.66),Y,BUSINESS,N,$1226.49
08/15/2023,08/07/2023,J49PCA-NJ,FTE,TOLL,,-,-,00:20:59,D30,35S,-,($0.66),Y,BUSINESS,N,$1227.15
08/15/2023,08/07/2023,J49PCA-NJ,FTE,TOLL,,-,-,00:18:47,D27,24S,-,($0.28),Y,BUSINESS,N,$1227.81
08/15/2023,08/07/2023,J49PCA-NJ,FTE,TOLL,,-,-,00:09:05,D68,72S,-,($0.28),Y,BUSINESS,N,$1228.09
08/15/2023,08/07/2023,J49PCA-NJ,FTE,TOLL,,-,-,00:07:20,D64,63S,-,($0.66),Y,BUSINESS,N,$1228.37
08/15/2023,08/07/2023,J49PCA-NJ,FTE,TOLL,,-,-,00:03:38,D58,65S,-,($0.66),Y,BUSINESS,N,$1229.03
08/15/2023,08/06/2023,J49PCA-NJ,FTE,TOLL,,-,-,23:58:20,D55,52S,-,($0.28),Y,BUSINESS,N,$1229.69
08/15/2023,08/14/2023,02214781100,SJ,TOLL,,-,-,00:20:56,APL,71,2,($1.35),Y,BUSINESS,N,$1229.97
08/15/2023,08/14/2023,02214781096,NJTP,TOLL,22:59:58,13 ,19E,23:23:26,9  ,09X,1,($3.15),Y,BUSINESS,N,$1231.32
08/14/2023,08/13/2023,U66RYG-NJ,MdTA,TOLL,,-,-,23:40:34,951,002,-,($0.49),Y,BUSINESS,N,$1234.47
08/14/2023,08/14/2023,U66RYG-NJ,MdTA,TOLL,,-,-,00:05:22,JFK,53,-,($8.00),Y,BUSINESS,N,$1234.96
08/14/2023,08/13/2023,U66RYG-NJ,MdTA,TOLL,,-,-,23:35:09,FMT,72,-,($4.00),Y,BUSINESS,N,$1242.96
08/14/2023,08/14/2023,02214781096,PANYNJ,TOLL,,-,-,07:45:58,GB ,02,-,($14.75),Y,BUSINESS,N,$1246.96
08/14/2023,08/09/2023,Z353579-NJ,SJ,TOLL,,-,-,17:50:56,APL,61,2,($1.35),Y,BUSINESS,N,$1261.71
08/14/2023,08/14/2023,02214781096,NJTP,TOLL,07:29:19,9  ,05E,07:44:04,13 ,09X,1,($4.20),Y,BUSINESS,N,$1263.06
08/14/2023,08/13/2023,02214781096,PANYNJ,TOLL,,-,-,17:22:38,LT ,10,-,($14.75),Y,BUSINESS,N,$1267.26
08/14/2023,08/13/2023,02214781096,MTAB&T,TOLL,,-,-,23:05:23,QMT,002,-,($11.19),Y,BUSINESS,N,$1282.01
08/14/2023,08/13/2023,02214781096,MTAB&T,TOLL,,-,-,17:54:20,QMT,015,-,($11.19),Y,BUSINESS,N,$1293.20
08/14/2023,08/14/2023,-,NJ E-ZPass,Service Fee,,-,-,03:38:09,-,-,-,($1.00),Y,-,-,$1304.39
08/14/2023,08/13/2023,02214781096,NJTP,TOLL,23:26:51,16E,23E,23:51:41,9  ,12X,1,($9.40),Y,BUSINESS,N,$1305.39
08/14/2023,08/14/2023,02214781100,GSP,TOLL,,-,-,01:12:21,TRV,05N,1,($1.01),Y,BUSINESS,N,$1314.79
08/14/2023,08/14/2023,02214781100,GSP,TOLL,,-,-,00:49:22,NGR,07N,1,($2.02),Y,BUSINESS,N,$1315.80
08/14/2023,08/13/2023,02214781100,SJ,TOLL,,-,-,18:16:26,APL,61,2,($1.35),Y,BUSINESS,N,$1317.82
08/13/2023,08/13/2023,02214781096,NJTP,TOLL,16:31:10,9  ,04E,17:06:45,16E,01X,1,($9.40),Y,BUSINESS,N,$1319.17
08/13/2023,08/13/2023,02214781100,GSP,TOLL,,-,-,17:50:20,BAR,08S,1,($2.02),Y,BUSINESS,N,$1328.57
08/13/2023,08/13/2023,02214781100,GSP,TOLL,,-,-,17:38:32,TRV,10S,1,($1.01),Y,BUSINESS,N,$1330.59
